8 8 8 8 8 8 8 8
8 4 8 4 4 8 8 4
4 4 7 4 4 4 4 7
8 4 4 4 4 4 4 4
4 7 4 4 4 4 8 4
4 4 4 4 7 4 4 8
8 8 4 8 7 4 4 8
8 8 8 8 8 8 8 8
0
